1111
1111111111


11


1
1
1
111
101
1S1
111
N